==============================================================================================================================================================================================================
#                                                                                                                                                                                                            #
#                                                                                                                                                                                                            #
#                                                                                                                                                                                              +             #
#                                                                                                                                                                                                            #
#                                                                                                                                                                                                            #
#                                                                                                           =======   1^^    ===   1^^    ===   1^^    ===   1^^    ===   1^^    ===   1^^    ===            #
#                                                                                                             vvv<#   1^^          1^^          1^^          1^^          1^^          1^^    #              #
#                                                                                                                <#                                                                           #              #
#                                                                                                                <#                                                                           #              #
#                                                                                                                <#                                                                      11111#              #11111
#                                                                                                                <#                                                                      >>>>>#              #<<<<<
#                                                                                                           =======                                                                           #              #
#                                                                                                             vvv<#                                                                           #              #
#                                                                                                                <#                                                                           #              #
#                                                                                                                <#                                                                      11111#              #11111
#                                                                                                                <#                                                                      >>>>>#              #<<<<<
#                                                                                                                <#                                                                           #              #
#                                                                                                           =======                                                                           #              #
#                                 ^                           ^                           ^                   vvv<#                                                                           #              #
#                                 #             ^             #             ^             #                      <#                                                                      11111#              #11111
#                                 #             #             #             #             #                      <#                                                                      >>>>>#              #<<<<<
#                                 #             #             #             #             #                      <#^^^^^^^^^^^^^^^^^^^^^^^^^^^^^^^^^^^^^^^^^^^^^^^^^^^^^^^^^^^^^^^^^^^^^^^^^^^#              #
======          ===============================================================================================================================================================================              #
#>                   <#                                                                                                        >2                                                             #              #
#>                   <#                                                                                                        >                                                              #              #
#>                   <#                                                                                                        >                                                              #              #
#>       =====       <#                                                                                                        >                                                              #>>>>>>>       #
#>                   <#                                                                                                        >                                                              #              #
#>                   <#                                                                                                        >  +                                                           #              #
#>                   <#                                                                                                        >                                                              #              #
#>                   <#                      ^^^^^^^^^           ^^^^^^^^^           ^^^^^^^^^           ^^^^^^^^^             >                                                              #              #
=======         =======            ====================================================================================================                                                       #              #
#>                   <#           2<                                                                                           #      #                                                       #              #
#>                   <#            <                                                                                           #       =====                                                  #              #
#>                   <#            <                                                                                           #           #                                                  #              #
#>       =====       <#            <                                                                                           #           =====                                              #              #
#>                   <#            <                                                                                           #           1^^^#                                              #              #
#>                   <#            <             ^                   ^                   ^                   ^                 #               =====                                          #              #
#>                   <#            <             #                   #                   #                   #                 #               2^^^#                                          #              #
#>                   <#            <         ^^^^#^^^^           ^^^^#^^^^           ^^^^#^^^^           ^^^^#^^^^             #                   =====                                      #              #
=======         =====================================================================================================          #                   1^^^#                                      #              #
#>                   <#                                                              #                                         #                       =====                                  #       <<<<<<<#
#>                   <#                                                              #                                         #                       2^^^#                                  #              #
#>                   <#                                                              #                                         #                           =====                              #              #
#>       =====       <#                                                              #                                         #                           1^^^#                              #              #
#>                   <#                                                              #                                         #                               =====                                         #
#>                   <#                                                              #                                    +    #                                   #                                         #
#>                                                                                   #                                         #                                   =====                                     #
#>                                                                                   #         ^^^       ^^^       ^^^         #                                   3^^^#                                     #
=======                                                                              #         =================================                                       =====                                 #
#>                              +                                                    #                                         #                                       2^^^#                                 =========================================================================================================================================================
#>                                                                                   #                                         #                                           =====                             #                                                                                                                                                       #
#>                                                                                   #                                         #                                           1^^^#                             #                                                                                                                                                       #
#>       =====        =================================================         ======                                         #                                               ===============================                                                                                                                                                       #
#>       vvvvv       <#                  1^^^^^^^^^^                  #>            <#                                         #                                                                                                                                                                                                                                     #
#>                   <#                                               #>            <#                                         #                                                                                                                                                                                                                                     #
#>                   <#                                               #>            <#                                         #                                                                                                                                                                                                                                     #
#>                   <#                                               ======        <#         ^^^       ^^^       ^^^         #                                                                                                                                                                                                                                     #
======           ======                                               #>            <=================================         #                                                                                                                                                                                                                                     #
#>                   <#                                               #>            <#                                         #                                                                            ========================^^^^^^^^^^^^^=======^^^^^^^^^^^^^=======^^^^^^^^^^^^^=======^^^^^^^^^^^^^=======^^^^^^^^^^^^^=                                   #
#>                   <#                                               #>            <#                                         #                                                                            #                #     #1            #     #1            #     #1            #     #1            #     #1            #                                   #
#>                   <#                                               #>        ======                                         #                                                                          ===                                                                                                                    #                                   #
#>       =====       <#                                               #>            <#                                         #                                               =           ==============================================================================================================================================                            #
#>       vvvvv       <#                                               #>            <#                                         #                                                              <#                                                                                                                                                                     #
#>                   <#                                               #>            <#                                         #                                                              <#                                                                                                                                                                     #
#>                   <#                                               #>            <#                                         #                             =                                <#                                                                                                                                                                     #
#>                   <#                                               ======        <#         ^^^       ^^^       ^^^         #                                                              <#                                                                                                                                                                     #
======           ======================================================>            <#         =================================                                                              <#                                                                                                                                                           W         #
#>                            #      #                                #>            <#         vvvvvvvvvvvvvvvvvvvvvvvvvvvvvvvvv                                                              <#                                                                                                                                                                     #
#>                            #      #                                #>            <#                                                                              =                         <#                                                                                                                   =                                                 #
#>                            #      #                                #>            <#                                                                                                        <#          =====             =               =               =            ====              ====                            ===========================================
#>       =====                #      #                                #>   ======   <#                                                                                                        <#                           1^              2^              3^                                                             <#                                          
#>       vvvvv                ========                                #>            <#                                                                                                         #   11111                                                                                                 =                <#                                          
#>                                                                    #>            <#                                                                                                         #   >>>>>                                                                                                                  <#                                          
#>                                                                    #>            <#                                                                                                         #   >>>>>                                                                                                                  <#                                          
#>^^^^^^^^^^^^^^^                                                     #>             ===========================================================================================================   >>>>>  =====                                                                                                           <#                                          
==========================================================            #>   ======    vvvvvvvvvvvvvvvvvvvvvvvvvvvvvvvvvvvvvvvvvv                                                                #                                                                                                                 =        <#                                          
#                            1^^^^^^^^                                #>                       vvvvvvvvvvv                                                                                     #   11111                                                                                                                  <#                                          
#                                                                     #>                         vvvvvvv                                                                                       #   >>>>>                                                                                      =                           <#                                          
#                                                                     #>                           vvv                                                                                         #   >>>>>                                                                                                  =               <#                                          
#                                                                     #>                                                                                                             + P       #   >>>>>  =====                                                                                                       =   <#                                          
#                                                                     #>   ======                                                                                                              #                                                                                                                          <#                                          
#                                                                     #>                                                                 ^^                                                    #                                                                                                                          <#                                          
#                                                                     #>                                                          ===============^^^^^^^^^=======          =====================                                                                                                  =                       <#                                          
#                                                                     #>                                                          #              =========       #^^^^^^^^^#                   #                             =====              =====              =====                                                  <#                                          
#                                                                     #>             ^^^^^                     ^^^^^              #                              ===========                   #                =====       2^^^^^             1^^^^^                                                       =             <#                                          
#                    ^^^^^^^        ^^^^^^^        ^^^^^^^            =============================================================                                                            #                                                                                    =                                     <#                                          
#            ===================================================================================================================================================================================                                                                                                                          <#                                          
#                                                                                               #                     #        #                                     #        #        #                                                                                                                                  <#                                          
#                                                                                               #                     #        #                                     #        #        #                                                                                                                        =         <#                                          
#                                                                                               #                     #        #                                     #        #        #                                                                           =====                         =                        <#                                          
#                                                                                               #                     #        #                                     #        #        #                                                                                                                                  <#                                          
#                                                                                               #                     #        #                                     #        #        #                                                                                                                           =      <#                                          
#                                                                                               #                     #        #                                     #        #        #                                                                                                =                                 <#                                          
#                                                                                               #                     #        #                                     #        #        #                                                                                                                  =               <#                                          
#                                                                                              1vvvvvvv2vvvvvvv3vvvvvvv       1vvvvvvv1vvvvvvv4vvvvvvv1vvvvvvv1vvvvvvv       1vvvvvvvvvv                  =====              =====              =====              =====                    =                             <#                                          
#                                                                                               =======================        =======================================        ==========                                    1^^^^^             1^^^^^                                                                     <#                                          
#     +                                                                                                                                                                                         +                                                                                                                         <#                                          
#            =             =             =             =             =             =                                                                                                                                                                                                                                      <#                                          
#            #^^^^^^^^^^^^^#^^^^^^^^^^^^^#^^^^^^^^^^^^^#^^^^^^^^^^^^^#^^^^^^^^^^^^^#                                                                                                                                           ^^^^^^^^^^^^^^^^^^^^^^^^^^^^^^^^^^^^^^^^^^^^^^^^^^^^^^^^^^^^^^^^^^^^^^^^^^^^^^^^^^^^^^^^^^^ #                                          
============================================================================================================================================================================================================================================================================================================================                                          
                                                                                               1^^^^^^^2^^^^^^^3^^^^^^^       1^^^^^^^1^^^^^^^4^^^^^^^1^^^^^^^1^^^^^^^       1^^^^^^^^^^