#================================================================================================================================================================================================================================================================================================================================================================================================================================================================================================#
#                                                                                                                                                                                                                                                                                                                                                                                                                                                                                                #
#                                                                                                                                                                                                                                                                                                                                                                                                                                                                                                #
#                                                                                                                                                                                                                                                                                                                                                                                                                                                                                                #
#                                                                                                                                                                                                                                                                                                                                                                                                                                                                                                #
#                                                                                                                                                                                                                                                                                                                                                                                                                                                                                                #
#                                                                                                                                                                                                                                                                                                                                                                                                                                                                                                #
#                                                                                                                                                                                                                                                                                                                                                                                                                                                                                                #
#                                                                                                                                                                                                                                                                                                                                                                                                                                                                                                #
#                                                                                                                                                                                                                                                                                                                                                                                                                                                                                                #
#                                                                                                                                                                                                ===========           ==========================                                                                 =======                                                                                                                                                                        #
#                                                                                                                                                                                                                     <#                        #                                                                 #     #                                                                                                                                                                        #
#                                                                                                                                                                                                                     <#                        #                                                                 #     #                                                                                                                                                                        #
#                                                                                                                                                                                                                     <#                        #                                                                 #     #                                                                                                                                                                        #
#                                                                                                                                                                                                                     <#                        #                                                       ===========     #                                                                                                                                                                        #
#                                                                                                                                                                            ===========                              <#                        #                                                       #               #                                                                                                                                                                        #
#                                                                                                                                                                                                                     <#                        #                                                       #               #                                                                                                                                                                        #
#                                                                                                                                                                                                                     <#                        #                                        ================               #                                                                                                                                                                        #
#                                                                                                                                                                                                                     <#                        #                                        #                              #                                                                                                                                                                        #
#                                                                                                                                                                                                                     <#                        #                                        #                              #                                                                                                                                                                        #
#                                                                                                                                                                                                                     <#                        ==========================================                              #===================================                               =========                ===                 ===                ======================================#
#                                                                                                                                                                            ===========                              <#                                                                                                                                   #^^^^^^^^^^^^^^^^^^^^^^^^^^^^^^^#       #^^^^^^^^^^^^^^^^# #^^^^^^^^^^^^^^^^^# #^^^^^^^^^^^^^^^^#                                     #
#                                                                                                                                                                                                                     <#                                                                                                                                                                                                                                                                         #
#                                                                                                                                                                                                                     <#                                                                                                                                                                                                                                                                         #
#                                                                                                                                                                                                                     <#                                                                                                                                                                                                                                                                         #
#                                                =============                                ======                                                                                              ===========         <#                                                                                                                                                                                                                                                                         #
#                                                                                                                                                                                                                     <#                                                                                                                                                                                                                                                                         #
#                                                                                                                                                                                                                     <#                                                                                                                                                                                                                                                                         #
#                                                                                                                                                                                                                     <#                                                                                                                                                                                                                                                                         #
#                                                                                                                                                                            ===========                              <#                                                                                                                                                                                                                                                                         #
#                   ==========                                                                                                                                                                                        <#                                                                                                                                                                                                                                                                         #
#                   #        #                    ============                                                                ============                ============                                                <#                                                                                                                                                                                                                                                                         #
#                   #        #                    #          #                                                                #          #                #          #                                                <#                                                                                                                                                                                                                                                                         #
#      P            #        #                    #          #^^^^^^^^^^^^^^^^^^^^^^^^^^^^^^^^^^^^^^^^^^^^^^^^^^^^^^^^^^^^^^^^#          #                #          # ^^^^^^^^^^^^^^^^^^^^^^^^^^^^^^^^^^^^^^^^^^^^^^^<#                                                                                                                                                                                                                                                                         #
#================================================================================================================================================================================================================================================================================================================================================================================================================================================================================================#