┌────────────────────────────────────────────────────────────────────────────────────────┐
│                                                                                        │
│                                                                                        │
│                                                                                        │
│                                                                                        │
│                                                                                        │
│                                                                                        │
│               ====                                                                     │
│                                                                                        │
│                            ====                                                        │
│                                                                                        │
│                                                                                        │
│                                      ====                                              │
│               ====                                                                     │
│                                                                                        │
│                            ====                                                        │
│                                                                                        │
│                                                                                        │
│                                      ====                                              │
│               ====                                                                     │
│                                                                                        │
│                            ====                                                        │
│                                                                                        │
│                                                                                        │
│                                      ====                                              │
│               ====                                                                     │
│                                                                                        │
│                            ====                                                        │
│                                                                                        │
│                                                                                        │
│                                      ====                                              │
│                                                       ====                             │
│                                                                                        │
│                                                                                        │
│                                                                                        │
│                                                         ======          ===            │
│                                                                                        │
│                                           ====                                         │
│               ====                                                                     │
│                                                                                        │
│                            ====                                                        │
│                                                                                        │
│                                                                                        │
│                                      ====                                              │
│                                                                                        │
└────────────────────────────────────────────────────────────────────────────────────────┘