┌──────────────────────────────────────────────────────────────────────────────────────────────────────────────────────────────────────────────────────────────────────┐
│                                                                                                                                                                      │
│                                                                                                                                                                      │
│                                                                                                                                                                      │
│                                                                                                                                                                      │
│                                                                                                                                                                      │
│                                                                   ============                                                                                       │
│                                                                                                                                                                      │
│                                                                                                                                                                      │
│                                                                                                                                                                      │
│                       ===============                                                        ==========                                                              │
│                                                                                                                                                                      │
│                                                                                                                                                                      │
│                                                                                                                                                                      │
│                                                  ======                                                                                                              │
│                                                                                                                                                                      │
│                                     ====                                                                                                                             │
│                                                                                                                                                                      │
│                                                                                                                                                                      │
│      ==========                                                                                                                                                      │
└──────────────────────────────────────────────────────────────────────────────────────────────────────────────────────────────────────────────────────────────────────┘